Transport and travel	TIME SHAPE PURPOSE SOUND PLACE GENERALIZATION SIZE HOW_TO_USE SPECIALIZATION PART
Food and drink	SHAPE SMELL PURPOSE SIMILARITY TASTE COLOR GENERALIZATION SIZE SPECIALIZATION PART
Culture and society	PURPOSE SIMILARITY COLOR GENERALIZATION SIZE SPECIALIZATION PART
Textile and clothing	SHAPE PURPOSE SIMILARITY COLOR MATERIAL PLACE GENERALIZATION SIZE HOW_TO_USE SPECIALIZATION PART
Language and linguistics	PURPOSE SIMILARITY SOUND GENERALIZATION SIZE SPECIALIZATION PART
Heraldry, honors, and vexillology	SHAPE PURPOSE SIMILARITY COLOR GENERALIZATION SIZE SPECIALIZATION PART
Mathematics	TIME SHAPE PURPOSE SIMILARITY GENERALIZATION SIZE HOW_TO_USE SPECIALIZATION PART
Biology	ACTIVITY SHAPE SMELL SIMILARITY TASTE COLOR GENERALIZATION SIZE SPECIALIZATION PART
History	SIMILARITY TIME PLACE GENERALIZATION SIZE SPECIALIZATION PART
Computing	TIME ACTIVITY PURPOSE SIMILARITY PLACE GENERALIZATION SIZE HOW_TO_USE SPECIALIZATION PART
Religion, mysticism and mythology	TIME ACTIVITY PURPOSE SIMILARITY GENERALIZATION SIZE SPECIALIZATION PART
Games and video games	TIME PURPOSE SIMILARITY SOUND COLOR GENERALIZATION SIZE HOW_TO_USE SPECIALIZATION PART
Physics and astronomy	TIME ACTIVITY SHAPE SIMILARITY SOUND COLOR PLACE GENERALIZATION SIZE SPECIALIZATION PART
Education	GENERALIZATION HOW_TO_USE SPECIALIZATION PART
Politics and government	TIME ACTIVITY PURPOSE SIMILARITY COLOR PLACE GENERALIZATION SIZE SPECIALIZATION PART
Meteorology	SMELL SOUND TASTE COLOR GENERALIZATION SIZE SPECIALIZATION PART
Law and crime	ACTIVITY PURPOSE TIME PLACE GENERALIZATION SIZE SPECIALIZATION PART
Philosophy and psychology	ACTIVITY SIMILARITY TIME GENERALIZATION SIZE SPECIALIZATION PART
Literature and theatre	TIME ACTIVITY PURPOSE SIMILARITY SOUND COLOR GENERALIZATION SIZE HOW_TO_USE SPECIALIZATION PART
Warfare and defense	PURPOSE TIME MATERIAL PLACE GENERALIZATION SIZE HOW_TO_USE SPECIALIZATION PART
Royalty and nobility	SHAPE SIMILARITY TIME COLOR GENERALIZATION SIZE SPECIALIZATION PART
Media	TIME SHAPE SIMILARITY SOUND COLOR GENERALIZATION SIZE HOW_TO_USE SPECIALIZATION PART
Geography and places	SHAPE SIMILARITY COLOR GENERALIZATION SIZE SPECIALIZATION PART PLACE
Art, architecture, and archaeology	SHAPE TIME COLOR MATERIAL GENERALIZATION SIZE HOW_TO_USE SPECIALIZATION PART
Health and medicine	TIME ACTIVITY SMELL PURPOSE TASTE GENERALIZATION SIZE SPECIALIZATION PART
Numismatics and currencies	TIME SHAPE PURPOSE SIMILARITY GENERALIZATION SIZE SPECIALIZATION PART
Sport and recreation	TIME ACTIVITY SHAPE PURPOSE COLOR PLACE GENERALIZATION SIZE HOW_TO_USE SPECIALIZATION PART
Animals	ACTIVITY SHAPE SMELL PURPOSE SIMILARITY SOUND COLOR PLACE GENERALIZATION SIZE SPECIALIZATION PART
Business, economics, and finance	ACTIVITY PURPOSE TIME GENERALIZATION SIZE HOW_TO_USE SPECIALIZATION PART
Music	TIME SHAPE PURPOSE SIMILARITY SOUND GENERALIZATION SIZE HOW_TO_USE SPECIALIZATION PART
Chemistry and mineralogy	SHAPE SMELL PURPOSE SIMILARITY TASTE COLOR GENERALIZATION SIZE SPECIALIZATION PART
Engineering and technology	TIME SHAPE PURPOSE SIMILARITY SOUND MATERIAL GENERALIZATION HOW_TO_USE SPECIALIZATION PART
Geology and geophysics	TIME SHAPE SIMILARITY SOUND COLOR GENERALIZATION SIZE SPECIALIZATION PART
Farming	ACTIVITY SMELL PURPOSE SOUND TASTE GENERALIZATION SIZE HOW_TO_USE SPECIALIZATION PART
