Animals	PLACE GENERALIZATION SIZE SPECIALIZATION ACTIVITY SIMILARITY SMELL
Art, architecture, and archaeology	PLACE MATERIAL COLOR SHAPE TIME
Biology	GENERALIZATION SPECIALIZATION SIZE SIMILARITY
Business, economics, and finance	GENERALIZATION SPECIALIZATION HOW_TO_USE
Chemistry and mineralogy	GENERALIZATION SPECIALIZATION PART SIMILARITY
Computing	GENERALIZATION SPECIALIZATION PART SIMILARITY
Culture and society	GENERALIZATION SPECIALIZATION PART SIMILARITY
Education	GENERALIZATION SPECIALIZATION PART
Engineering and technology	MATERIAL GENERALIZATION SPECIALIZATION PURPOSE
Farming	COLOR GENERALIZATION SIMILARITY SIZE
Food and drink	COLOR PLACE GENERALIZATION TASTE SMELL
Games and video games	ACTIVITY GENERALIZATION PART
Geography and places	PLACE GENERALIZATION
Geology and geophysics	GENERALIZATION SPECIALIZATION PART SIMILARITY
Health and medicine	GENERALIZATION SPECIALIZATION PART SIMILARITY
Heraldry, honors, and vexillology	GENERALIZATION SPECIALIZATION PART SIMILARITY COLOR SIZE TIME
History	TIME PLACE
Language and linguistics	GENERALIZATION SPECIALIZATION SIMILARITY
Law and crime	GENERALIZATION SPECIALIZATION PART SIMILARITY
Literature and theatre	GENERALIZATION SPECIALIZATION PART SIMILARITY TIME
Mathematics	GENERALIZATION SPECIALIZATION PART SIMILARITY
Media	GENERALIZATION SPECIALIZATION PART SIMILARITY
Meteorology	GENERALIZATION SPECIALIZATION PART SIMILARITY
Music	GENERALIZATION SPECIALIZATION PART SIMILARITY SOUND TIME
Numismatics and currencies	SIMILARITY MATERIAL TIME PLACE
Philosophy and psychology	GENERALIZATION SPECIALIZATION PART SIMILARITY
Physics and astronomy	GENERALIZATION SPECIALIZATION PART SIMILARITY
Politics and government	GENERALIZATION SPECIALIZATION PART SIMILARITY
Religion, mysticism and mythology	GENERALIZATION SPECIALIZATION PART SIMILARITY
Royalty and nobility	GENERALIZATION SPECIALIZATION PART SIMILARITY TIME PLACE
Sport and recreation	GENERALIZATION SPECIALIZATION PART SIMILARITY
Textile and clothing	GENERALIZATION SPECIALIZATION PART SIMILARITY MATERIAL
Transport and travel	GENERALIZATION SPECIALIZATION PART SIMILARITY HOW_TO_USE
Warfare and defense	GENERALIZATION SPECIALIZATION PART SIMILARITY HOW_TO_USE PURPOSE
